
1111111111111111111111111111111111111111111111
1C00000011111111111111111111111111111111111111
1000011111111100001111111110000111111111000011
10011E00000P1100001111111110000111111111000011