1111111111111
1C00000011111
100001111111
10011E00000P1
1111111111111