11111111111111
1E000000000001
11100101001001
10100100101011
1P0000000100C1
11111111111111