1111111111111111111111111111111111
1E0000000000001C00000C000000000001
1110010100100000101001000000010101
1110010010101010001001000000010101
100000000C00C000000110000000000001
1000000000111100000000000111100001
1000000000111100001100000011110001
1000000000111100000000000111100001
1000000000111100000110000111100001
1000000000111100000000000111100001
1000000000111100011000000011110001
1000000000111100000000000111100001
10000000P0000000000000000111100001
1111111111111111111111111111111111