1111111111111111111111
10E000000000000C000001
1110010100100000101001
1010010010101010001001
1P0000000100C000000001
1111111111111111111111