1111111111111111111111111
1CM00000000000000000000C1
1001100001100011111100001
1001100001100110000110001
1001100001100000000110001
1001111111100011111100001
1000000001100110000000001
100000000110M110000000001
1000000001100111111110001
1E000000000000000000000P1
1111111111111111111111111