1111111111111111111111111
10M1111111111110M00000M01
1000MMMMMMM11100000M00001
10000000000011001111111C1
1000MMM0000011000110E1111
101C100010100000000010P01
1011101010111001110000001
100000000000000C111111111
1111111111111111111111111