111111111111111111111111111111111
110011111111100011000000011M11001
100111111111000111001000011000011
110011111110001111011000011111001
100111111100011111111000111110011
110011111000111111110001111111001
10011111000111111110M011111110011
110011110000000001000111111111001
100111100000000001000110011110011
110011110000E0C00C00P100011111001
100111111111110001111111111110011
110011111111110001111111111111001
100111111111110001111111111110011
111111111111111111111111111111111