111111111
1P000C001
1C0001101
10E00M001
111111111